NO   ./assets/brick.xpm
SO   ./assets/cobblestone.xpm
EA   ./assets/deepslate.xpm
WE   ./assets/stonebrick.xpm
C    255,1,0
F    0,255,0

1111111111
1000000001
10000N0001
1000000001
1111011111
