NO   ./assets/brick.xpm
SO   ./assets/cobblestone.xpm
EA   ./assets/deepslate.xpm
WE   ./assets/stonebrick.xpm
C    10,1,255
F    0,255,0

111111111111111111111111111111111111111111111111111111111111111111111111111111111111111111
 10000000000000000000000000000000000000001
  1000000000000000000000000000000000000000111
   10000000000000000000000000000000000000001
    1000000000000000000000000000000000000000111
     100000000000000000000000000000000000000011
      100000000000000000000000000000000000000011
       100000000000000000000000000000000000000011
        100000000000000000000000000000000000000011
         100000000000000000000000000000000000000011
          100000000000000000000000000000000000000011
           100000000000000000000000000000000000000011
            100000000000000000000000000000000000000011
             100000000000000000000000000000000000000011
              1000000000000000000000000000000000000000111
               10E000000000000000000000000000000000000011
                101111111111111111111111111111111111111111
                1011
                101 
                1011 
                1011                                               1
                1011 1 1 11 1  11  1 1 1 11  1 1 1 1 11  1 1 1 1 1 11 1 
                101 1 1 1
                1011   1
                1011  1
                101  1  1   
111111111111111110111
1000000000000000001 11
1011111111111111111 11
101               11
101          1 1
101         1  1
101            1 1                                                                                                                                                                                                                                                                                                                                                                                                                                                                                                                                                                          11
1011 1 1
10001 11 
 111 1 1
 111  1 1 111  1 1
  1 1
1 
   1 11
    1  
      1                 1
        1               1 
          1             1 1
            1             1
              1           1
                 1         
                  1    1 
                     1 1                        11 1 1 1 11 1 11111111111
                     1 1                                     1101010101011
                     1 1                                     1010101010101
                      1 11 1 1  11111111111111111111111111111111111111111111
