NO   ./assets/fnorth.xpm
SO   ./assets/arcadi.xpm
EA   ./assets/jstopka.xpm
WE   ./assets/ttas.xpm
C    255,1,0
F    0,255,0

1111111111
1000000001
1000000001
1000000001
1111111111
